########
#   .$ #
#  * #.#
# **$  #
#$ $. $#
# #. #.#
#@$   .#
########
